0000000000S0E0000000
00000000001010000000
00000000001011111110
00011111111000000010
00010000000000111110
01110000000000100000
01000111111000100000
01000100001000111110
01000100001000000010
01000100001000000010
01111100001111111110
00000000000000000000
PPPPPPPPPPPPPPPPPPPP
PPPPPPPPPPPPPPPPPPPP