00000000000000000000
S1111111111111111110
00000000000000000010
00000000000000000010
01111111111111111110
01000000000000000000
01000000000000000000
01111111111111111110
00000000000000000010
01111111111111111110
01000000000000000000
0111111111111111111E
PPPPPPPPPPPPPPPPPPPP
PPPPPPPPPPPPPPPPPPPP