00000000000000000000
S1111111111110000000
00000000000011111110
00000000000000000010
01111111111111100010
01000000000000100010
01000000000000100010
01111111110000100010
00000000010000111110
01111111110000000000
01000000000000000000
0111111111111111111E
PPPPPPPPPPPPPPPPPPPP
PPPPPPPPPPPPPPPPPPPP