00000000000000000000
00111110000000000000
0010001000111111111E
00100010001000000000
00100010001111111100
00100010000000000100
00100010111111111100
00100010100000000000
00100010111111111110
00100010000000000010
S1100011111111111110
00000000000000000000
PPPPPPPPPPPPPPPPPPPP
PPPPPPPPPPPPPPPPPPPP