00000000000000000000
00111110000000000000
0010001000000011111E
00100010001111100000
00100011111000000000
00100000000000000000
00100000000001111100
00111000000001000100
00001111111111000100
00000000000000000100
S1111111111111111100
00000000000000000000
PPPPPPPPPPPPPPPPPPPP
PPPPPPPPPPPPPPPPPPPP