00000000000000000000
S1100000000000000000
00100000000000000000
00111111111101110000
00000000000101010000
00000000000101010000
00000000000101010000
00111111111101010000
00100000000001010000
00100000011111011000
0011111111000000111E
00000000000000000000
PPPPPPPPPPPPPPPPPPPP
PPPPPPPPPPPPPPPPPPPP