00000000000000000000
S1100000000000000000
00100000000000000000
00100011111101110000
00100010000101010000
00111110000101010000
00000000000101010000
00111100111101010000
00100111100001010000
00100000011111011000
0011111111000000111E
00000000000000000000
PPPPPPPPPPPPPPPPPPPP
PPPPPPPPPPPPPPPPPPPP